5 5
0 0 0 0 0 0 0 0
0 0 0 0 0 0 0 0
0 0 0 0 14 0 0 0
0 0 0 15 15 15 0 0
0 0 0 15 1 15 0 0
0 0 0 0 0 0 0 0
0 0 0 0 0 0 0 0
0 0 0 0 0 0 0 0